.....~..............
.....~..............
....@~..............
.....~............%%
.....~.........%%.%%
.....~.........%%...
.....~..............
.@...~..............
====================
.....~..@....%%.....
%%...~..............
%%...~......%%@.....
.....~......%%......
.....~..............
.....~..............
....@~..............
.....~..@...........
.....~..............
.....~@.............
.....~..............
